TIME_STEP	double
ITERATIONS	integer
TIME_STEP_MAX	double
SPACE_STEP	integer
SURFACE_GRID_DENSITY	integer
INTERACTION_RADIUS	integer
RADIAL_DIRECTIONS	integer
RADIAL_SUBDIVISIONS	integer
ACCURATE_3D_REACTIONS	boolean
CENTER_MOLECULES_ON_GRID	boolean
VACANCY_SEARCH_DISTANCE	double
MICROSCOPIC_REVERSIBILITY	onoffenum

BOX_TRIANGULATION_REPORT	onoffenum
DIFFUSION_CONSTANT_REPORT	onbriefenum
FINAL_SUMMARY	onoffenum

DEGENERATE_POLYGONS	warningenum
NEGATIVE_DIFFUSION_CONSTANT	warningenum
MISSING_SURFACE_ORIENTATION	errorenum
NEGATIVE_REACTION_RATE	warningenum
USELESS_VOLUME_ORIENTATION	warningenum
HIGH_REACTION_PROBABILITY	ignoredenum
LIFETIME_TOO_SHORT = WARNING
LIFETIME_THRESHOLD = 50
MISSED_REACTIONS = WARNING
MISSED_REACTION_THRESHOLD = 0.001
